
11111
1C0E1
10P01
11111
11111
