1111111111111
10010000000C1
1K000111110K1
1P0011E000001
100000K000001
1111111111111