1111111111111
10010K00000C1
10000K1111101
1P0011E000001
1111111111111
