111111111111111
100000000C00001
10100101001K001
101001001010101
1E0000000C000K1
111111111111111
