1111111111111111111111
1E00000000000C00000001
1010010100100000101001
1010010010101010001001
1P0000000C00C0000000K1
111111111111111111111
