11111111111111111
1E00K00000C000001
101001010010000K1
10100100101010101
1P0000000C00C0001
11111111111111111
